2 0 0 0 0 0 0 0 0 0 0 0 0 0 0 0 0 0 0 4 
2 0 0 0 6 1 7 0 0 0 0 0 0 0 0 0 0 0 0 4 
2 0 0 0 5 9 9 7 0 0 0 0 0 0 0 0 0 0 0 4 
9 7 0 0 0 4 9 9 1 7 0 0 0 0 0 0 0 0 0 4 
9 8 0 0 0 4 9 9 9 9 1 1 1 1 1 1 1 1 1 9 
2 0 0 0 0 4 9 9 9 9 9 9 9 9 9 9 9 9 9 9 
2 0 0 0 6 9 9 9 3 3 3 3 9 9 3 3 3 3 3 9
2 0 0 0 4 9 9 8 0 0 0 0 5 8 0 0 0 0 0 4 
9 7 0 0 4 9 8 0 0 0 0 0 0 0 0 0 0 0 0 4 
9 8 0 0 5 8 0 0 0 0 0 0 0 0 0 0 0 0 0 4 
2 0 0 0 0 0 0 0 0 0 0 0 0 6 1 1 1 1 1 9 
9 1 1 1 1 1 1 1 1 1 1 1 1 9 9 9 9 9 9 9 
1

18
75  375   
225 275  
148 192       
75  125   
151 53       
435 125   
675 175  
715 175  
755 175  
795 175  
848 143       
825 118       
871 118       
802 93       
894 93       
848 93       
848 59       
848 29       

575 430 1

3
400 350 0
450 350 0
500 350 0

850 425

720 350

1
825 188

1
600 150

1
50 520 0 

2
1 400 97 450 97 400 97 
1 60 497 150 497 60 497

0

0