0 0 0 0 0 0 0 0  0 0 0 0 0  0 0 0 0 0 0 4   
0 0 0 0 0 0 0 0  0 0 0 0 0  0 0 0 0 0 0 4   
1 1 1 7 0 0 0 0  0 0 0 0 0  0 0 0 6 1 1 9   
9 9 9 2 0 0 0 0  0 0 0 0 0  0 0 0 4 9 9 9   
9 9 9 2 0 0 0 0  0 0 0 0 0  0 0 0 4 9 9 9   
9 9 9 2 0 0 0 0  0 6 7 0 0  0 0 0 4 9 9 9    
9 3 3 8 0 0 0 0  0 5 8 0 0  0 0 0 4 9 9 9    
2 0 0 0 0 0 0 13 0 0 0 0 13 0 0 0 5 3 3 9   
2 0 0 0 0 0 0 0  0 0 0 0 0  0 0 0 0 0 0 4   
9 1 1 1 1 1 1 7  0 0 0 0 11 0 0 0 0 0 0 4   
9 9 9 9 9 9 9 9  1 1 1 1 9  7 0 0 0 0 0 4   
9 9 9 9 9 9 9 9  9 9 9 9 9  9 1 1 1 1 1 4   

0

12
604  177 
572  110 
533  71 
506  42 
474  71 
428  119 
392 170 
370  224 
334  171 
261  84 
299  116 
218  69 

750 450 1

6
400 450 1
450 450 1
500 450 1
550 450 1
450 200 1
500 200 1

870 475

800 400

1
50 438

1
100 50

1
850 70 0

1
2 100 391 320 391 100 391

2
600 300
350 300

0